#Darkness* *A cleric who has access to the Darkness domain can use either the Darkness domain presented in Chapter 4 of this book or the one in Book of Vile Darkness.
#?A draegloth cleric of Lolth can choose the Demonic domain as one of her domains.

# Vile and Exalted Deities - p.189
Abbathor.MOD	DOMAINS:Greed
Asmodeus.MOD	DOMAINS:Diabolic
Baalzebul.MOD	DOMAINS:Diabolic
Barachiel.MOD	DOMAINS:Herald
Berronar Truesilver.MOD	DOMAINS:Community
Cyric.MOD	DOMAINS:Pain
Cyrrollalee.MOD	DOMAINS:Community
Demogorgon.MOD	DOMAINS:Corruption,Demonic
Domiel.MOD		DOMAINS:Celestial
Eldath.MOD	DOMAINS:Community
Gargauth.MOD	DOMAINS:Corruption
Graz'zt.MOD	DOMAINS:Darkness (FR),Darkness,Demonic
Hanali Celanil.MOD	DOMAINS:Pleasure
Hathor.MOD	DOMAINS:Community
Horus-Re.MOD	DOMAINS:Glory
Ilmater.MOD	DOMAINS:Endurance
Kharash.MOD	DOMAINS:Wrath
Lathander.MOD	DOMAINS:Glory
Lliira.MOD	DOMAINS:Joy
Lolth.MOD	DOMAINS:Darkness (FR),Darkness
Lolth.MOD	DOMAINS:Demonic
Loviatar.MOD	DOMAINS:Pain
Lurue.MOD	DOMAINS:Fey
Malar.MOD		DOMAINS:Bestial
Mammon.MOD	DOMAINS:Diabolic
Mask.MOD	DOMAINS:Darkness (FR),Darkness
Mephistopheles.MOD	DOMAINS:Diabolic
Mielikki.MOD	DOMAINS:Fey
Nobanion.MOD	DOMAINS:Fey
Pistis Sophia.MOD	DOMAINS:Celestial
Rillifane Rallathil.MOD	DOMAINS:Fey
Set.MOD	DOMAINS:Darkness (FR),Darkness
Shar.MOD	DOMAINS:Darkness (FR),Darkness
Sharess.MOD	DOMAINS:Pleasure
Shargaas.MOD	DOMAINS:Darkness (FR),Darkness
Sune.MOD	DOMAINS:Pleasure
Tiamat.MOD	DOMAINS:Greed
Tyr.MOD	DOMAINS:Wrath
Urdlen.MOD	DOMAINS:Greed
Yeenoghu.MOD	DOMAINS:Bestial,Demonic
Yurtrus.MOD	DOMAINS:Corruption
