SOURCELONG:Complete Warrior	SOURCESHORT:Completewarrior	SOURCEDATE:2003-12

### COMPLETE WARRIOR - Dec 2003
# Spell Name									Classes of caster					Domains granting the spell	School			Sub-School			Spell Descriptors			Type		Components		Casting Time			Range				Item		Target Area or Effect						Duration								Save Info								Spell Resistance					Description																		Source Page
Augment Familiar							CLASSES:Hexblade=1|Sorcerer,Wizard=2						SCHOOL:Transmutation										TYPE:Arcane	COMPS:V,S		CASTTIME:1 standard action	RANGE:Close			ITEM:Potion	TARGETAREA:Your familiar					DURATION:Concentration + (CASTERLEVEL) rounds		SAVEINFO:Fort negates (harmless)	SPELLRES:Yes (harmless)				DESC:Your Familiar becomes more powerful.													SOURCEPAGE:p.116
Cloak of Bravery							CLASSES:Paladin=2|Cleric=3			DOMAINS:Courage=3			SCHOOL:Abjuration						DESCRIPTOR:Mind-Affecting	TYPE:Divine	COMPS:V,S		CASTTIME:1 standard action	RANGE:60 ft.		ITEM:Potion	TARGETAREA:60-ft.-radius emanation centered on you	DURATION:(CASTERLEVEL*10) minutes				SAVEINFO:Will negates (harmless)				SPELLRES:Yes (harmless)				DESC:You and your allies gain a bonus on saves against fear.								SOURCEPAGE:p.117
Cloak of Bravery, Greater	KEY:Cloak of Bravery (Greater)								DOMAINS:Courage=9			SCHOOL:Abjuration						DESCRIPTOR:Mind-Affecting	TYPE:Divine	COMPS:V,S		CASTTIME:1 standard action	RANGE:1 mile; see text			TARGETAREA:1-mile-radius emanation centered on you	DURATION:(CASTERLEVEL) hours					SAVEINFO:Will negates (harmless)				SPELLRES:Yes (harmless)				DESC:You and your allies gain a bonus on saves against fear.									SOURCEPAGE:p.117
Cursed Blade									CLASSES:Assassin,Hexblade=4								SCHOOL:Necromancy											TYPE:Arcane	COMPS:V		CASTTIME:1 standard action	RANGE:Touch					TARGETAREA:One melee weapon					DURATION:(CASTERLEVEL) minutes				SAVEINFO:None							SPELLRES:No						DESC:Wounds dealt by weapon can't be healed.												SOURCEPAGE:p.117
Hound of Doom									CLASSES:Hexblade=3									SCHOOL:Illusion		SUBSCHOOL:Shadow							TYPE:Arcane	COMPS:V,S		CASTTIME:1 round			RANGE:Close			ITEM:Potion	TARGETAREA:Shadowy hound					DURATION:(CASTERLEVEL) minutes (D) or until destroyed	SAVEINFO:None							SPELLRES:No						DESC:Creates shadowy protector.														SOURCEPAGE:p.117-118
Lion's Roar																	DOMAINS:Courage=8			SCHOOL:Evocation						DESCRIPTOR:Sonic			TYPE:Divine	COMPS:V,S,DF	CASTTIME:1 standard action	RANGE:120 ft.				TARGETAREA:120-ft.-radius burst centered on you		DURATION:Instantaneous or (CASTERLEVEL) minutes		SAVEINFO:Fort partial or Will negates (harmless)	SPELLRES:Yes or Yes (harmless); see text	DESC:Deals ((CASTERLEVEL+1)/2)d8 to enemies; allies get +1 on attack and saves against fear, plus temporary hp.	SOURCEPAGE:p.118
Phantom Threat									CLASSES:Bard,Hexblade=1									SCHOOL:Illusion		SUBSCHOOL:Phantasm	DESCRIPTOR:Mind-Affecting	TYPE:Arcane	COMPS:V,S		CASTTIME:1 standard action	RANGE:Close			ITEM:Potion	TARGETAREA:One creature						DURATION:(CASTERLEVEL) rounds					SAVEINFO:Will negates						SPELLRES:Yes					DESC:Subject thinks it's flanked.														SOURCEPAGE:p.118
Valiant Fury																DOMAINS:Courage=5		SCHOOL:Transmutation										TYPE:Divine	COMPS:V,S,DF	CASTTIME:1 standard action	RANGE:Close					TARGETAREA:One living creature				DURATION:(CASTERLEVEL) rounds					SAVEINFO:Will negates (harmless)				SPELLRES:Yes (harmless)				DESC:+4 Str, Con;+2 Will Saves; extra attacks; cures 1d8+(min(CASTERLEVEL,20)).						SOURCEPAGE:p.118
###END COMPLETE WARRIOR - Dec 2003

###Block: Hexblade Class Spell List
Alarm.MOD	CLASSES:Hexblade=1
Arcane Mark.MOD	CLASSES:Hexblade=1
Augment Familiar.MOD	CLASSES:Hexblade=1
Cause Fear.MOD	CLASSES:Hexblade=1
Charm Person.MOD	CLASSES:Hexblade=1
Detect Magic.MOD	CLASSES:Hexblade=1
Disguise Self.MOD	CLASSES:Hexblade=1
Entropic Shield.MOD	CLASSES:Hexblade=1
Expeditious Retreat.MOD	CLASSES:Hexblade=1
Identify.MOD	CLASSES:Hexblade=1
Light.MOD	CLASSES:Hexblade=1
Magic Weapon.MOD	CLASSES:Hexblade=1
Mount.MOD	CLASSES:Hexblade=1
Nystul's Magic Aura.MOD	CLASSES:Hexblade=1
Phantom Threat.MOD	CLASSES:Hexblade=1
Prestidigitation.MOD	CLASSES:Hexblade=1
Protection from Chaos.MOD	CLASSES:Hexblade=1
Protection from Evil.MOD	CLASSES:Hexblade=1
Protection from Good.MOD	CLASSES:Hexblade=1
Protection from Law.MOD	CLASSES:Hexblade=1
Read Magic.MOD	CLASSES:Hexblade=1
Sleep.MOD	CLASSES:Hexblade=1
Tasha's Hideous Laughter.MOD	CLASSES:Hexblade=1
Undetectable Alignment.MOD	CLASSES:Hexblade=1
Unseen Servant.MOD	CLASSES:Hexblade=1

Alter Self.MOD	CLASSES:Hexblade=2
Blindness/Deafness.MOD	CLASSES:Hexblade=2
Bull's Strength.MOD	CLASSES:Hexblade=2
Darkness.MOD	CLASSES:Hexblade=2
Eagle's Splendor.MOD	CLASSES:Hexblade=2
Enthrall.MOD	CLASSES:Hexblade=2
False Life.MOD	CLASSES:Hexblade=2
Glitterdust.MOD	CLASSES:Hexblade=2
Invisibility.MOD	CLASSES:Hexblade=2
Mirror Image.MOD	CLASSES:Hexblade=2
Protection from Arrows.MOD	CLASSES:Hexblade=2
Pyrotechnics.MOD	CLASSES:Hexblade=2
Rage.MOD	CLASSES:Hexblade=2
Resist Energy.MOD	CLASSES:Hexblade=2
See Invisibility.MOD	CLASSES:Hexblade=2
Spider Climb.MOD	CLASSES:Hexblade=2
Suggestion.MOD	CLASSES:Hexblade=2
Summon Swarm.MOD	CLASSES:Hexblade=2
Touch of Idiocy.MOD	CLASSES:Hexblade=2

Arcane Sight.MOD	CLASSES:Hexblade=3
Charm Monster.MOD	CLASSES:Hexblade=3
Confusion.MOD	CLASSES:Hexblade=3
Deep Slumber.MOD	CLASSES:Hexblade=3
Dispel Magic.MOD	CLASSES:Hexblade=3
Hound of Doom.MOD	CLASSES:Hexblade=3
Invisibility Sphere.MOD	CLASSES:Hexblade=3
Magic Weapon (Greater).MOD	CLASSES:Hexblade=3
Nondetection.MOD	CLASSES:Hexblade=3
Phantom Steed.MOD	CLASSES:Hexblade=3
Poison.MOD	CLASSES:Hexblade=3
Protection from Energy.MOD	CLASSES:Hexblade=3
Repel Vermin.MOD	CLASSES:Hexblade=3
Slow.MOD	CLASSES:Hexblade=3
Stinking Cloud.MOD	CLASSES:Hexblade=3
Vampiric Touch.MOD	CLASSES:Hexblade=3
Wind Wall.MOD	CLASSES:Hexblade=3

Baleful Polymorph.MOD	CLASSES:Hexblade=4
Break Enchantment.MOD	CLASSES:Hexblade=4
Contact Other Plane.MOD	CLASSES:Hexblade=4
Cursed Blade.MOD	CLASSES:Hexblade=4
Detect Scrying.MOD	CLASSES:Hexblade=4
Dimension Door.MOD	CLASSES:Hexblade=4
Dominate Person.MOD	CLASSES:Hexblade=4
Enervation.MOD	CLASSES:Hexblade=4
Fear.MOD	CLASSES:Hexblade=4
Invisibility (Greater).MOD	CLASSES:Hexblade=4
Phantasmal Killer.MOD	CLASSES:Hexblade=4
Polymorph.MOD	CLASSES:Hexblade=4
Scrying.MOD	CLASSES:Hexblade=4
Sending.MOD	CLASSES:Hexblade=4
Solid Fog.MOD	CLASSES:Hexblade=4
