# CVS $Revision: $ $Author: $ -- Thu Jul 10 13:59:32 2014 -- reformated by prettylst.pl v1.51 (build 24365)


# Deity Name		Domains
Abaddon			DOMAINS:Catastrophe,Chaos,Death,Evil|PREALIGN:
Abraxas			DOMAINS:Chaos,Evil,Knowledge,Magic,Protection|PREALIGN:
Anarazel			DOMAINS:Chaos,Earth,Evil,Fear|PREALIGN:
Arachnadia			DOMAINS:Chaos,Destruction,Evil,Trickery|PREALIGN:
Astaroth			DOMAINS:Chaos,Evil,Knowledge,Prophecy|PREALIGN:
Azazel			DOMAINS:Animal,Chaos,Disease,Evil|PREALIGN:
Azidahaka			DOMAINS:Chaos,Evil,Fear,Pain|PREALIGN:
Baphomet			DOMAINS:Chaos,Evil,Protection,Strength|PREALIGN:
Behemoth			DOMAINS:Animal,Chaos,Evil,Strength|PREALIGN:
Decarabia			DOMAINS:Air,Chaos,Evil,Subterfuge|PREALIGN:
Demogorgon			DOMAINS:Chaos,Evil,Fear,Pain|PREALIGN:
Eligor			DOMAINS:Chaos,Evil,Knowledge,War|PREALIGN:
Flauros			DOMAINS:Chaos,Evil,Fire,Sun|PREALIGN:
Gamigin			DOMAINS:Chaos,Death,Evil,Knowledge|PREALIGN:
Haagenti			DOMAINS:Change,Chaos,Earth,Evil|PREALIGN:
Ipos				DOMAINS:Chaos,Eloquence,Evil,Trickery|PREALIGN:
Kostchtchie			DOMAINS:Chaos,Crippling,Evil,Strength|PREALIGN:
Lord of Many Forms	DOMAINS:Change,Chaos,Evil,Pain|PREALIGN:
Marbas			DOMAINS:Change,Chaos,Disease,Evil|PREALIGN:
Orcus				DOMAINS:Chaos,Death,Destruction,Evil|PREALIGN:
Nocticula			DOMAINS:Chaos,Evil,Healing,Luck,Plant|PREALIGN:
Pazuzu			DOMAINS:Air,Animal,Chaos,Evil|PREALIGN:
Raum				DOMAINS:Catastrophe,Chaos,Evil,Prophecy|PREALIGN:
Sabnach			DOMAINS:Chaos,Disease,Evil,Protection|PREALIGN:
Seere				DOMAINS:Chaos,Evil,Knowledge,Travel|PREALIGN:
Shax				DOMAINS:Chaos,Crippling,Evil,Subterfuge|PREALIGN:
Socothbenoth		DOMAINS:Chaos,Evil,Pleasure,Trickery|PREALIGN:
Vaz'zht			DOMAINS:Chaos,Eloquence,Evil,Subterfuge|PREALIGN:
Vepar				DOMAINS:Chaos,Evil,Travel,Water|PREALIGN:
Yughooragh			DOMAINS:Animal,Chaos,Death,Evil|PREALIGN:
Zhar'Ub-Luur		DOMAINS:Chaos,Eloquence,Evil,Trickery|PREALIGN:
